DEFAI	MATRICULA,10	; Arreglo de matrículas 
DEFI	i	; Contador i						
DEFS	s										
DEFAS	r,10									
DEFAD	d,10									
DEFD	doub									
; Inicializar contador i en cero		
PRTM "MENSAJE CON ESPACIOS"
PUSHKS "HOLA123" 
PUSHKI	0	
POPI	i	
Ciclo:	PUSHI	i	
POPIDX		
READAI	MATRICULA	
PRTAI	MATRICULA	
INC	i			
PUSHI	i	
PUSHKI	10	
CMPLT		
JMPT	Ciclo	
HALT		

